!	![Punc]
"	"[Punc]
&	&[Punc]
'	'[Punc]
(	([Punc]
)	)[Punc]
,	,[Punc]
-	-[Punc]
-eli	eli[Dem+Pos]
.	.[Punc]
/	/[Punc]
000	000[Num]
1	1[Num]
1.1	1.1[Num]
100	100[Num]
15	15[Num]
152	152[Num]
18	18[Num]
195	195[Num]
1969	1969[Num]
1997	1997[Num]
1998	1998[Num]
1999	1999[Num]
2	2[Num]
2.2	2.2[Num]
2.3.2	2.3.2[Num]
2000	2000[Num]
2001	2001[Num]
2003	2003[Num]
2004	2004[Num]
2005	2005[Num]
2006	2006[Num]
2007	2007[Num]
21	21[Num]
24	24[Num]
25(1)	25(1)[Num]
27(4)	27(4)[Num]
27699	27699[Num]
29(b)	29(b)[Num]
3	3[Num]
3.1	3.1[Num]
32	32[Num]
38	38[Num]
39	39[Num]
4	4[Num]
5	5[Num]
5.6	5.6[Num]
6	6[Num]
68	68[Num]
7.00	7.00[Num]
74a	74a[Num]
9	9[Num]
90	90[Num]
:	:[Punc]
;	;[Punc]
?	?[Punc]
[	[[Punc]
]	][Punc]
a.	a.[Abbr]
aba	aba[Dem+Pos]
ababhexeshi	a[NPrePre]-ba[BPre]-bhexeshi[NStem]
abaninzi	aba[AdjPref]-ninzi[AdjStem]
abasebenzi	a[NPrePre]-ba[BPre]-sebenzi[NStem]
abathathi-nxaxheba	a[NPrePre]-ba[BPre]-thathi[NStem]-n[BPre]-xaxheba[NStem]
abc	abc[Abbr]
abo	abo[Dem+Pos]
achaphazelekayo	a[RelConc]-chaphazel[VRoot]-ek[NeutExt]-a[VerbTerm]-yo[RelSuf]
achievable	achievable[Foreign]
act	act[Foreign]
action	action[Foreign]
acts	acts[Foreign]
afana	a[SC]-fan[VRoot]-a[VerbTerm]
african	african[ProperName]
afrika	afrika[ProperName]
ahluka-hlukeneyo	a[RelConc]-ahluk[VRoot]-a[VerbTerm]-hluk[VRoot]-en[RecipExt]-e[VerbTerm]-yo[RelSuf]
ahlukeneyo	a[RelConc]-ahlukan[VRoot]-e[VerbTerm]-yo[RelSuf]
aids	aids[Abbr]
akhoyo	a[RelConc]-kho[Adv]-yo[RelSuf]
akukho	a[NegPre]-ku[CopPre]-kho[Adv]
amacandelo	a[NPrePre]-ma[BPre]-candelo[NStem]
amadoda	a[NPrePre]-ma[BPre]-doda[NStem]
amagosa	a[NPrePre]-ma[BPre]-gosa[NStem]
amakhosikazi	a[NPrePre]-ma[BPre]-khosikazi[NStem]
amalungelo	a[NPrePre]-ma[BPre]-lungelo[NStem]
amalungiselelo	a[NPrePre]-ma[BPre]-lungiselelo[NStem]
amalungu	a[NPrePre]-ma[BPre]-lungu[NStem]
amancinci	ama[AdjPref]-ncinci[AdjStem]
amaninzi	ama[AdjPref]-ninzi[AdjStem]
amanqaku	a[NPrePre]-ma[BPre]-nqaku[NStem]
amanyathelo	a[NPrePre]-ma[BPre]-nyathelo[NStem]
amanye	ama[AdjPref]-nye[AdjStem]
amanzi	a[NPrePre]-ma[BPre]-nzi[NStem]
amaqela	a[NPrePre]-ma[BPre]-qela[NStem]
amashishini	a[NPrePre]-ma[BPre]-shishini[NStem]
amathuba	a[NPrePre]-ma[BPre]-thuba[NStem]
amaxesha	a[NPrePre]-ma[BPre]-xesha[NStem]
amaziko	a[NPrePre]-ma[BPre]-ziko[NStem]
amazwe	a[NPrePre]-ma[BPre]-zwe[NStem]
and	and[Foreign]
apha	apha[Dem+Pos]
aphezulu	a[RelConc]-phezulu[Adv]
apho	apho[Dem+Pos]
areas	areas[Foreign]
arnstein	arnstein[ProperName]
asia	asia[ProperName]
association	association[Foreign]
athile	a[RelConc]-th[VRoot]-ile[Perf]
aze	a[SC]-ze[AuxVStem]
babo	ba[PossConc]-bo[PronStem]
bani	bani[Interrog]
banike	ba[SC]-nik[VRoot]-e[VerbTerm]
banzi	banzi[RelStem]
batho	batho[ProperName]
bay	bay[ProperName]
baze	ba[SC]-ze[AuxVStem]
bengingqi	ba[PossConc]-i[NPrePre]-n[BPre]-gingqi[NStem]
bewadi	ba[PossConc]-i[NPrePre]-wadi[NStem]
bhala	bhal[VRoot]-a[VerbTerm]
bomzantsi	ba[PossConc]-u[NPrePre]-mzantsi[ProperName]
bonke	bo[QuantConc]-nke[QuantStem]
bucala	bucala[Adv]
budgeting	budgeting[Foreign]
buthathaka	buthathaka[RelStem]
cala	cala[NStem]
candelo	candelo[NStem]
cape	cape[ProperName]
cbo	cbo[Abbr]
cbp	cbp[Abbr]
cdws	cdws[Abbr]
cela	cel[VRoot]-a[VerbTerm]
charters	charters[Foreign]
chatha	chatha[Ideoph]
chaza	chaz[VRoot]-a[VerbTerm]
chu	chu[Ideoph]
civics	civics[Foreign]
community-based	community-based[Foreign]
company	company[Foreign]
conflictus	conflictus[Foreign]
copy	copy[Foreign]
corporation	corporation[Foreign]
cpf	cpf[Abbr]
cwecwe	cwecwe[NStem]
cycle	cycle[Foreign]
dayagram	dayagram[NStem]
de	de[AuxVStem]
decision-makers	decision-makers[Foreign]
demarcation	demarcation[Foreign]
development	development[Foreign]
diesika	diesika[NStem]
dolophu	dolophu[NStem]
e	e[Abbr]
ebalulekileyo	e[RelConc]-balulek[VRoot]-il[Perf]-e[VerbTerm]-yo[RelSuf]
ebhunga	a[PossConc]-i[NPrePre]-bhunga[NStem]
ecac	ecac[Abbr]
edlulileyo	e[RelConc]-dlul[VRoot]-il[Perf]-e[VerbTerm]-yo[RelSuf]
efuna	e[RelConc]-fun[VRoot]-a[VerbTerm]
egameni	e[LocPre]-i[NPrePre]-gama[NStem]-ini[LocSuf]
ekhulwini	e[LocPre]-khulu[NStem]-ini[LocSuf]
ekomiti	a[PossConc]-i[NPrePre]-komiti[NStem]
ekubeni	ekubeni[Conj]
ekuhlaleni	e[LocPre]-u[NPrePre]-ku[BPre]-hlal[VRoot]-a[VerbTerm]-ini[LocSuf]
ekuqinisekiseni	e[LocPre]-u[NPrePre]-ku[BPre]-qinisek[VRoot]-is[CausExt]-a[VerbTerm]-ini[LocSuf]
ekwakheni	e[LocPre]-u[NPrePre]-ku[BPre]-akh[VRoot]-a[VerbTerm]-ini[LocSuf]
ekwenzeni	e[LocPre]-u[NPrePre]-ku[BPre]-enz[VRoot]-a[VerbTerm]-ini[LocSuf]
elandelayo	e[RelConc]-landel[VRoot]-a[VerbTerm]-yo[RelSuf]
eli	eli[Dem+Pos]
elide	eli[AdjPref]-de[AdjStem]
elinye	eli[AdjPref]-nye[AdjStem]
elithile	eli[RelConc]-th[VRoot]-ile[Perf]
elo	elo[Dem+Pos]
eluntwini	e[LocPre]-u[NPrePre]-lu[BPre]-ntu[NStem]-ini[LocSuf]
emazijongwe	e[RelConc]-ma[ImpPre]-zi[OC]-jong[VRoot]-w[PassExt]-e[VerbTerm]
emihlanu	emi[AdjPref]-hlanu[AdjStem]
eminye	emi[AdjPref]-nye[AdjStem]
emithathu	emi[AdjPref]-thathu[AdjStem]
emva	e[LocPre]-u[NPrePre]-m[BPre]-va[NStem]
endaweni	e[LocPre]-i[NPrePre]-n[BPre]-dawo[NStem]-ini[LocSuf]
enkulu	en[AdjPref]-khulu[AdjStem]
enye	e[AdjPref]-nye[AdjStem]
enze	enz[VRoot]-e[VerbTerm]
ephambili	e[RelConc]-phambili[Adv]
epreli	epreli[ProperName]
es	es[ProperName]
esebenzayo	e[RelConc]-sebenz[VRoot]-a[VerbTerm]-yo[RelSuf]
esekelwe	e[RelConc]-sek[VRoot]-el[ApplExt]-w[PassExt]-e[VerbTerm]
esi	esi[Dem+Pos]
esifundo	a[PossConc]-i[NPrePre]-si[BPre]-fundo[NStem]
esisekwe	esi[RelConc]-sek[VRoot]-w[PassExt]-e[VerbTerm]
eso	eso[Dem+Pos]
esweni	e[LocPre]-so[NStem]-ini[LocSuf]
ethile	e[RelConc]-th[VRoot]-ile[Perf]
ewadini	e[LocPre]-wadi[NStem]-ini[LocSuf]
exco	exco[ProperName]
eyodwa	e[RelConc]-yo[QuantConc]-dwa[QuantStem]
ezahluka-hlukeneyo	ezi[RelConc]-ahluk[VRoot]-a[VerbTerm]-hluk[VRoot]-en[RecipExt]-e[VerbTerm]-yo[RelSuf]
ezahlukeneyo	ezi[RelConc]-ahlukan[VRoot]-e[VerbTerm]-yo[RelSuf]
ezentlalo	e[RelConc]-za[PossConc]-i[NPrePre]-n[BPre]-tlalo[NStem]
ezi	ezi[Dem+Pos]
ezifana	ezi[RelConc]-fan[VRoot]-a[VerbTerm]
ezikhoyo	ezi[RelConc]-kho[Adv]-yo[RelSuf]
ezimbini	ezin[AdjPref]-bini[AdjStem]
ezingundoqo	ezi[RelConc]-ng[CopPre]-u[NPrePre]-ndoqo[NStem]
ezininzi	ezi[AdjPref]-ninzi[AdjStem]
ezinkulu	ezin[AdjPref]-khulu[AdjStem]
ezintsha	ezin[AdjPref]-tsha[AdjStem]
ezinye	ezi[AdjPref]-nye[AdjStem]
eziphambili	ezi[RelConc]-phambili[Adv]
ezisisiseko	ezi[RelConc]-s[CopPre]-i[NPrePre]-si[BPre]-seko[NStem]
ezithile	ezi[RelConc]-th[VRoot]-ile[Perf]
eziyimfuneko	ezi[RelConc]-y[CopPre]-i[NPrePre]-m[BPre]-funeko[NStem]
ezizodwa	ezi[RelConc]-zo[QuantConc]-dwa[QuantStem]
ezo	ezo[Dem+Pos]
ezoqoqosho	ezoqoqosho[ProperName]
facilitators	facilitators[Foreign]
fama	fama[NStem]
fet	fet[Abbr]
finance	finance[Foreign]
flats	flats[ProperName]
fomu	fomu[NStem]
for	for[Foreign]
foram	foram[NStem]
forum	forum[Foreign]
framework	framework[Foreign]
futhi	futhi[Conj]
ga	ga[Ideoph]
gadalala	gadalala[Adv]
gama	gama[NStem]
gazette	gazette[Foreign]
gca	gca[Ideoph]
gingci	gingci[Ideoph]
government	government[Foreign]
gqolo	gqolo[Ideoph]
guide	guide[Foreign]
gwenxa	gwenxa[Adv]
handbook	handbook[Foreign]
hayi	hayi[Interjec]
hiv	hiv[Abbr]
hlahlo	hlahlo[NStem]
hleze	hleze[Adv]
hlobo	hlobo[NStem]
i-cbp	i[NPrePre]-cbp[Abbr]
i-idp	i[NPrePre]-idp[Abbr]
i-pms	i[NPrePre]-pms[Abbr]
ibakala	i[NPrePre]-bakala[NStem]
ibatho	i[NPrePre]-batho[ProperName]
ibhunga	i[NPrePre]-bhunga[NStem]
icandelo	i[NPrePre]-candelo[NStem]
ict	ict[Abbr]
idp	idp[Abbr]
ifuna	i[SC]-fun[VRoot]-a[VerbTerm]
igalelo	i[NPrePre]-galelo[NStem]
iikomiti	i[NPrePre]-i[BPre]-komiti[NStem]
iimeko	i[NPrePre]-i[BPre]-meko[NStem]
iimfuno	i[NPrePre]-in[BPre]-funo[NStem]
iimpendulo	i[NPrePre]-im[BPre]-pendulo[NStem]
iindawo	i[NPrePre]-in[BPre]-dawo[NStem]
iindima	i[NPrePre]-in[BPre]-dima[NStem]
iindleko	i[NPrePre]-in[BPre]-dleko[NStem]
iindlela	i[NPrePre]-in[BPre]-dlela[NStem]
iingcebiso	i[NPrePre]-in[BPre]-gcebiso[NStem]
iinguquko	i[NPrePre]-in[BPre]-guquko[NStem]
iingxaki	i[NPrePre]-in[BPre]-gxaki[NStem]
iingxelo	i[NPrePre]-in[BPre]-gxelo[NStem]
iinjongo	i[NPrePre]-in[BPre]-jongo[NStem]
iinkcukacha	i[NPrePre]-in[BPre]-kcukacha[NStem]
iinkokeli	i[NPrePre]-in[BPre]-kokeli[NStem]
iinkonzo	i[NPrePre]-in[BPre]-konzo[NStem]
iinkqubo	i[NPrePre]-in[BPre]-kqubo[NStem]
iintlanganiso	i[NPrePre]-in[BPre]-tlanganiso[NStem]
iinzuzo	i[NPrePre]-in[BPre]-zuzo[NStem]
iiprojekthi	i[NPrePre]-i[BPre]-projekthi[NStem]
iiyantlukwano	i[NPrePre]-i[BPre]-yantlukwano[NStem]
ikhomishoni	i[NPrePre]-khomishoni[NStem]
ikomiti	i[NPrePre]-komiti[NStem]
iliso	i[NPrePre]-li[BPre]-so[NStem]
ilizwe	i[NPrePre]-li[BPre]-zwe[NStem]
ilungu	i[NPrePre]-lungu[NStem]
imali	i[NPrePre]-mali[NStem]
imeko	i[NPrePre]-meko[NStem]
imfundo	i[NPrePre]-m[BPre]-fundo[NStem]
imiba	i[NPrePre]-mi[BPre]-ba[NStem]
imibandela	i[NPrePre]-mi[BPre]-bandela[NStem]
imibutho	i[NPrePre]-mi[BPre]-butho[NStem]
imibuzo	i[NPrePre]-mi[BPre]-buzo[NStem]
imidla	i[NPrePre]-mi[BPre]-dla[NStem]
imigangatho	i[NPrePre]-mi[BPre]-gangatho[NStem]
imigaqo-nkqubo	i[NPrePre]-mi[BPre]-gaqo[NStem]-n[BPre]-kqubo[NStem]
imimandla	i[NPrePre]-mi[BPre]-mandla[NStem]
imingeni	i[NPrePre]-mi[BPre]-ngeni[NStem]
imisebenzi	i[NPrePre]-mi[BPre]-sebenzi[NStem]
imithetho	i[NPrePre]-mi[BPre]-thetho[NStem]
imithetho-siseko	i[NPrePre]-mi[BPre]-thetho[NStem]-si[BPre]-seko[NStem]
imithombo	i[NPrePre]-mi[BPre]-thombo[NStem]
imizuzu	i[NPrePre]-mi[BPre]-zuzu[NStem]
inani	i[NPrePre]-nani[NStem]
indawo	i[NPrePre]-n[BPre]-dawo[NStem]
indima	i[NPrePre]-n[BPre]-dima[NStem]
indleko	i[NPrePre]-n[BPre]-dleko[NStem]
indlela	i[NPrePre]-n[BPre]-dlela[NStem]
ingakumbi	i[SC]-ngakumbi[Adv]
ingeniso	i[NPrePre]-ngeniso[NStem]
ingqalelo	i[NPrePre]-n[BPre]-gqalelo[NStem]
ingqiqo	i[NPrePre]-n[BPre]-gqiqo[NStem]
ingxaki	i[NPrePre]-n[BPre]-gxaki[NStem]
ingxelo	i[NPrePre]-n[BPre]-gxelo[NStem]
ingxoxo	i[NPrePre]-n[BPre]-gxoxo[NStem]
injongo	i[NPrePre]-n[BPre]-jongo[NStem]
inkcazo	i[NPrePre]-n[BPre]-kcazo[NStem]
inkonzo	i[NPrePre]-n[BPre]-konzo[NStem]
inkqubela-phambili	i[NPrePre]-n[BPre]-kqubela[NStem]-phambili[Adv]
inkqubo	i[NPrePre]-n[BPre]-kqubo[NStem]
inkxaso	i[NPrePre]-n[BPre]-kxaso[NStem]
integrated	integrated[Foreign]
international	international[Foreign]
intlanganiso	i[NPrePre]-n[BPre]-tlanganiso[NStem]
into	i[NPrePre]-n[BPre]-to[NStem]
inxaxheba	i[NPrePre]-n[BPre]-xaxheba[NStem]
inyathelo	i[NPrePre]-nyathelo[NStem]
inzuzo	i[NPrePre]-n[BPre]-zuzo[NStem]
iprojekthi	i[NPrePre]-projekthi[NStem]
iqela	i[NPrePre]-qela[NStem]
iqonga	i[NPrePre]-qonga[NStem]
isahluko	i[NPrePre]-si[BPre]-ahluko[NStem]
isazobe	i[NPrePre]-sa[BPre]-zobe[NStem]
ishishini	i[NPrePre]-shishini[NStem]
isicwangciso	i[NPrePre]-si[BPre]-cwangciso[NStem]
isigaba	i[NPrePre]-si[BPre]-gaba[NStem]
isigqibo	i[NPrePre]-si[BPre]-gqibo[NStem]
isikhokelo	i[NPrePre]-si[BPre]-khokelo[NStem]
isikhundla	i[NPrePre]-si[BPre]-khundla[NStem]
isiphumo	i[NPrePre]-si[BPre]-phumo[NStem]
isiseko	i[NPrePre]-si[BPre]-seko[NStem]
isixokelelwano	i[NPrePre]-si[BPre]-xokelelwano[NStem]
ithuba	i[NPrePre]-thuba[NStem]
iwadi	i[NPrePre]-wadi[NStem]
ixesha	i[NPrePre]-xesha[NStem]
iza	i[SC]-za[AuxVStem]
izakhono	i[NPrePre]-zi[BPre]-khono[NStem]
izalathisi	i[NPrePre]-zi[BPre]-alathisi[NStem]
izibonelelo	i[NPrePre]-zi[BPre]-bonelelo[NStem]
izicwangciso	i[NPrePre]-zi[BPre]-cwangciso[NStem]
izidingo	i[NPrePre]-zi[BPre]-dingo[NStem]
izigqibo	i[NPrePre]-zi[BPre]-gqibo[NStem]
izikhokelo	i[NPrePre]-zi[BPre]-khokelo[NStem]
izimvo	i[NPrePre]-zim[BPre]-vo[NStem]
izinto	i[NPrePre]-zin[BPre]-to[NStem]
iziphumo	i[NPrePre]-zi[BPre]-phumo[NStem]
izixhobo	i[NPrePre]-zi[BPre]-xhobo[NStem]
izixokelelwano	i[NPrePre]-zi[BPre]-xokelelwano[NStem]
izizathu	i[NPrePre]-zi[BPre]-zathu[NStem]
jikelele	jikelele[Adv]
jones	jones[ProperName]
jonga	jong[VRoot]-a[VerbTerm]
julayi	julayi[NStem]
june	june[Foreign]
juni	juni[ProperName]
kakhulu	ka[AdvPre]-khulu[AdjStem]
kakuhle	kaku[AdvPre]-hle[AdjStem]
kaloku	kaloku[Adv]
kambe	kambe[Conj]
kananjalo	kananjalo[Adv]
kanjalo	kanjalo[Adv]
kanti	kanti[Conj]
kanye	kanye[Adv]
karhulumente	ka[PossKA]-u[NPrePre]-rhulumente[NStem]
kazwelonke	ka[PossKA]-u[NPrePre]-zwelonke[NStem]
ke	ke[Conj]
key	key[Foreign]
kho	kho[Adv]
khona	khona[Adv]
kodwa	kodwa[Conj]
kokuba	kwa[PossConc]-ukuba[Conj]
koloni	koloni[ProperName]
koluntu	kwa[PossConc]-u[NPrePre]-lu[BPre]-ntu[NStem]
komiti	komiti[NStem]
komsebenzi	kwa[PossConc]-u[NPrePre]-m[BPre]-sebenzi[NStem]
kontrakthi	kontrakthi[NStem]
koqoqosho	kwa[PossConc]-u[NPrePre]-qoqosho[NStem]
kpi	kpi[Abbr]
kpis	kpis[Abbr]
kras	kras[Abbr]
kratya	kratya[Ideoph]
kuba	kuba[Conj]
kubantu	ku[LocPre]-a[NPrePre]-ba[BPre]-ntu[NStem]
kubekho	ku[CopPre]-be[CopPre]-kho[Adv]
kubo	ku[LocPre]-bo[PronStem]
kufanele	ku[SC]-fanel[VRoot]-e[VerbTerm]
kufuna	ku[SC]-fun[VRoot]-a[VerbTerm]
kufuphi	kufuphi[Adv]
kukamasipala	ku[PossConc]-ka[PossKA]-masipala[NStem]
kukho	ku[CopPre]-kho[Adv]
kukuba	k[CopPre]-ukuba[Conj]
kulawulo	ku[LocPre]-u[NPrePre]-lawulo[NStem]
kule	ku[LocPre]-le[Dem+Pos]
kuluntu	ku[LocPre]-u[NPrePre]-lu[BPre]-ntu[NStem]
kumashishini	ku[LocPre]-a[NPrePre]-ma[BPre]-shishini[NStem]
kumasipala	ku[LocPre]-u[NPrePre]-masipala[NStem]
kumaziko	ku[LocPre]-a[NPrePre]-ma[BPre]-ziko[NStem]
kumazwe	ku[LocPre]-a[NPrePre]-ma[BPre]-zwe[NStem]
kumele	ku[SC]-mele[AuxVStem]
kummandla	ku[LocPre]-u[NPrePre]-m[BPre]-mandla[NStem]
kumsebenzi	ku[LocPre]-u[NPrePre]-m[BPre]-sebenzi[NStem]
kunceda	ku[SC]-nced[VRoot]-a[VerbTerm]
kunjalo	ku[CopPre]-njalo[Adv]
kuphela	kuphela[Adv]
kuphuhliso	ku[LocPre]-u[NPrePre]-phuhliso[NStem]
kuqhutywa	ku[SC]-qhub[VRoot]-w[PassExt]-a[VerbTerm]
kuqoqosho	ku[LocPre]-u[NPrePre]-qoqosho[NStem]
kurhulumente	ku[LocPre]-u[NPrePre]-rhulumente[NStem]
kusetyenziswa	ku[SC]-sebenz[VRoot]-is[CausExt]-w[PassExt]-a[VerbTerm]
kuthatha	ku[SC]-thath[VRoot]-a[VerbTerm]
kutheni	kutheni[Interrog]
kuwo	ku[LocPre]-wo[PronStem]
kuyimfuneko	ku[CopPre]-y[CopPre]-i[NPrePre]-m[BPre]-funeko[NStem]
kuyo	ku[LocPre]-yo[PronStem]
kuze	kuze[Conj]
kuzo	ku[LocPre]-zo[PronStem]
kwa	kwa[Adv]
kwabantu	kwa[PossConc]-a[NPrePre]-ba[BPre]-ntu[NStem]
kwakhona	kwa[AdvPre]-khona[Adv]
kwakunye	kwa[AdvPre]-kunye[Conj]
kwamakhosikazi	kwa[PossConc]-a[NPrePre]-ma[BPre]-khosikazi[NStem]
kwaye	kwaye[Conj]
kwaze	kwaze[Conj]
kwazo	kwa[PossConc]-zo[PronStem]
kwazulu-natal	kwazulu-natal[ProperName]
kweenkonzo	kwa[PossConc]-i[NPrePre]-in[BPre]-konzo[NStem]
kwenziwe	ku[SC]-enz[VRoot]-iw[PassExt]-e[VerbTerm]
kweprojekthi	kwa[PossConc]-i[NPrePre]-projekthi[NStem]
kwesi	ku[LocPre]-esi[Dem+Pos]
kwesicwangciso	kwa[PossConc]-i[NPrePre]-si[BPre]-cwangciso[NStem]
kwexesha	kwa[PossConc]-i[NPrePre]-xesha[NStem]
kwezi	ku[LocPre]-ezi[Dem+Pos]
kwezigqibo	kwa[PossConc]-i[NPrePre]-zi[BPre]-gqibo[NStem]
kweziphumo	kwa[PossConc]-i[NPrePre]-zi[BPre]-phumo[NStem]
kwi-idp	ku[LocPre]-i[NPrePre]-idp[Abbr]
kwibhunga	ku[LocPre]-i[NPrePre]-bhunga[NStem]
kwicandelo	ku[LocPre]-i[NPrePre]-candelo[NStem]
kwifliptshathi	ku[LocPre]-i[NPrePre]-fliptshathi[NStem]
kwiikomiti	ku[LocPre]-i[NPrePre]-i[BPre]-komiti[NStem]
kwiinkonzo	ku[LocPre]-i[NPrePre]-in[BPre]-konzo[NStem]
kwiinkqubo	ku[LocPre]-i[NPrePre]-in[BPre]-kqubo[NStem]
kwiiprojekthi	ku[LocPre]-i[NPrePre]-i[BPre]-projekthi[NStem]
kwikomiti	ku[LocPre]-i[NPrePre]-komiti[NStem]
kwimiba	ku[LocPre]-i[NPrePre]-mi[BPre]-ba[NStem]
kwimimandla	ku[LocPre]-i[NPrePre]-mi[BPre]-mandla[NStem]
kwiminyaka	ku[LocPre]-i[NPrePre]-mi[BPre]-nyaka[NStem]
kwimisebenzi	ku[LocPre]-i[NPrePre]-mi[BPre]-sebenzi[NStem]
kwindawo	ku[LocPre]-i[NPrePre]-n[BPre]-dawo[NStem]
kwindlela	ku[LocPre]-i[NPrePre]-n[BPre]-dlela[NStem]
kwingingqi	ku[LocPre]-i[NPrePre]-n[BPre]-gingqi[NStem]
kwinkonzo	ku[LocPre]-i[NPrePre]-n[BPre]-khonzo[NStem]
kwinkqubo	ku[LocPre]-i[NPrePre]-n[BPre]-kqubo[NStem]
kwinqanaba	ku[LocPre]-i[NPrePre]-nqanaba[NStem]
kwintlanganiso	ku[LocPre]-i[NPrePre]-n[BPre]-tlanganiso[NStem]
kwiphepha	ku[LocPre]-i[NPrePre]-phepha[NStem]
kwiprojekthi	ku[LocPre]-i[NPrePre]-projekthi[NStem]
kwiqela	ku[LocPre]-i[NPrePre]-qela[NStem]
kwiwadi	ku[LocPre]-i[NPrePre]-wadi[NStem]
kwixesha	ku[LocPre]-i[NPrePre]-xesha[NStem]
kwizinto	ku[LocPre]-i[NPrePre]-zin[BPre]-to[NStem]
la	la[Dem+Pos]
labahlali	la[PossConc]-a[NPrePre]-ba[BPre]-hlali[NStem]
labantu	la[PossConc]-a[NPrePre]-ba[BPre]-ntu[NStem]
labemi	la[PossConc]-a[NPrePre]-be[BPre]-mi[NStem]
labo	la[PossConc]-bo[PronStem]
labucala	la[PossConc]-bucala[Adv]
lakho	la[PossConc]-kho[PossPron]
lali	lali[NStem]
land	land[Foreign]
le	le[Dem+Pos]
league	league[Foreign]
lebhunga	la[PossConc]-i[NPrePre]-bhunga[NStem]
leengxoxo	la[PossConc]-i[NPrePre]-in[BPre]-gxoxo[NStem]
leeto	leeto[ProperName]
lekomiti	la[PossConc]-i[NPrePre]-komiti[NStem]
lewadi	la[PossConc]-i[NPrePre]-wadi[NStem]
leyo	leyo[Dem+Pos]
libhunga	l[CopPre]-i[NPrePre]-bhunga[NStem]
likamasipala	li[PossConc]-ka[PossKA]-masipala[NStem]
lize	li[SC]-ze[AuxVStem]
lo	lo[Dem+Pos]
local	local[Foreign]
logama	logama[Adv]
lohlahlo	lwa[PossConc]-u[NPrePre]-hlahlo[NStem]
lonke	lo[QuantConc]-nke[QuantStem]
loo	loo[Dem+Pos]
lowo	lowo[Dem+Pos]
lukamasipala	lu[PossConc]-ka[PossKA]-masipala[NStem]
lukarhulumente	lu[PossConc]-ka[PossKA]-rhulumente[NStem]
lula	lula[Adv]
lungelelwano	lungelelwano[NStem]
lungelo	lungelo[NStem]
lungiselelo	lungiselelo[NStem]
lwabahlali	lwa[PossConc]-ba[BPre]-hlali[NStem]
lwabiwo-mali	lu[BPre]-abiwo[NStem]-mali[NStem]
lwabo	lwa[PossConc]-bo[PronStem]
lweenkonzo	lwa[PossConc]-i[NPrePre]-in[BPre]-konzo[NStem]
lweeprojekthi	lwa[PossConc]-i[NPrePre]-i[BPre]-projekthi[NStem]
lwehlabathi	lwa[PossConc]-i[NPrePre]-hlabathi[NStem]
lwempilo	lwa[PossConc]-i[NPrePre]-m[BPre]-philo[NStem]
lwengingqi	lwa[PossConc]-i[NPrePre]-n[BPre]-gingqi[NStem]
lwengxelo	lwa[PossConc]-i[NPrePre]-n[BPre]-gxelo[NStem]
lweprojekthi	lwa[PossConc]-i[NPrePre]-projekthi[NStem]
lwesicwangciso	lwa[PossConc]-i[NPrePre]-si[BPre]-cwangciso[NStem]
lwesini	lwa[PossConc]-i[NPrePre]-si[BPre]-ni[NStem]
m	m[Abbr]
macala	macala[Adv]
mahlangu	mahlangu[ProperName]
mahluko	mahluko[NStem]
malunga	malunga[Adv]
malungu	malungu[NStem]
management	management[Foreign]
mandulo	mandulo[Adv]
mars	mars[ProperName]
masipala	masipala[NStem]
matrix	matrix[Foreign]
mbalwa	mbalwa[RelStem]
mdgs	mdgs[Abbr]
measurable	measurable[Foreign]
meko	meko[NStem]
mfiliba	mfiliba[RelStem]
mfma	mfma[Abbr]
mhlawumbi	mhlawumbi[Adv]
minicipal	minicipal[Foreign]
modeli	modeli[NStem]
modyuli	modyuli[NStem]
mofolo	mofolo[ProperName]
mosaic	mosaic[Foreign]
mpefu	mpefu[ProperName]
msa	msa[Abbr]
msebenzi	m[BPre]-sebenzi[NStem]
msinyane	msinyane[Adv]
msp	msp[Abbr]
multi-year	multi-year[Foreign]
municipal	municipal[Foreign]
municipality	municipality[Foreign]
musa	musa[AuxVStem]
mva	mva[Adv]
mvunyane	mvunyane[NStem]
mw	mw[Abbr]
mzantsi	mzantsi[ProperName]
na	na[Interrog]
nabantu	na[AdvPre]-a[NPrePre]-ba[BPre]-ntu[NStem]
nabo	na[AdvPre]-bo[PronStem]
nalapho	na[AdvPre]-l[CopPre]-apho[Dem+Pos]
namadoda	na[AdvPre]-a[NPrePre]-ma[BPre]-doda[NStem]
namanye	na[AdvPre]-ama[AdjPref]-nye[AdjStem]
namhlanje	namhlanje[Adv]
nangona	nangona[Conj]
nantsi	nantsi[Cop]
national	national[Foreign]
nawo	na[AdvPre]-wo[PronStem]
naxa	naxa[Conj]
naye	na[AdvPre]-ye[PronStem]
nayiphi	na[AdvPre]-yi[EnumConc]-phi[EnumStem]
nayo	na[AdvPre]-yo[PronStem]
nazo	na[AdvPre]-zo[PronStem]
ndawo	n[BPre]-dawo[NStem]
ndim	ndim[Cop]
ndlela	n[BPre]-dlela[NStem]
ne-idp	na[AdvPre]-i[NPrePre]-idp[Abbr]
nebhunga	na[AdvPre]-i[NPrePre]-bhunga[NStem]
neekomiti	na[AdvPre]-i[NPrePre]-i[BPre]-komiti[NStem]
neemfuno	na[AdvPre]-i[NPrePre]-in[BPre]-funo[NStem]
neenkonzo	na[AdvPre]-i[NPrePre]-in[BPre]-konzo[NStem]
neenkqubo	na[AdvPre]-i[NPrePre]-in[BPre]-kqubo[NStem]
neeprojekthi	na[AdvPre]-i[NPrePre]-i[BPre]-projekthi[NStem]
nekomiti	na[AdvPre]-i[NPrePre]-komiti[NStem]
nemiba	na[AdvPre]-i[NPrePre]-mi[BPre]-ba[NStem]
nemibutho	na[AdvPre]-i[NPrePre]-mi[BPre]-butho[NStem]
nemisebenzi	na[AdvPre]-i[NPrePre]-mi[BPre]-sebenzi[NStem]
nendlela	na[AdvPre]-i[NPrePre]-n[BPre]-dlela[NStem]
nengomso	nengomso[Adv]
nenkqubo	na[AdvPre]-i[NPrePre]-n[BPre]-kqubo[NStem]
neqela	na[AdvPre]-i[NPrePre]-qela[NStem]
nesicwangciso	na[AdvPre]-i[NPrePre]-si[BPre]-cwangciso[NStem]
nezakhono	na[AdvPre]-i[NPrePre]-zi[BPre]-khono[NStem]
nezinto	na[AdvPre]-i[NPrePre]-zin[BPre]-to[NStem]
nezinye	na[AdvPre]-ezi[AdjPref]-nye[AdjStem]
ngaba	ngaba[Conj]
ngabe	ngabe[AuxVStem]
ngakumbi	ngakumbi[Adv]
ngale	nga[AdvPre]-le[Dem+Pos]
ngalinye	nga[AdvPre]-li[EnumConc]-nye[EnumStem]
ngamnye	nga[AdvPre]-m[EnumConc]-nye[EnumStem]
nganye	nga[AdvPre]-nye[EnumStem]
ngaphambi	nga[AdvPre]-phambi[Adv]
ngaphandle	nga[AdvPre]-phandle[Adv]
ngathi	ngathi[Adv]
ngayo	nga[AdvPre]-yo[PronStem]
ngazo	nga[AdvPre]-zo[PronStem]
ngcono	ngcono[Adv]
ngeendlela	nga[AdvPre]-i[NPrePre]-in[BPre]-dlela[NStem]
ngeenjongo	nga[AdvPre]-i[NPrePre]-in[BPre]-jongo[NStem]
ngemiba	nga[AdvPre]-i[NPrePre]-mi[BPre]-ba[NStem]
ngempumelelo	nga[AdvPre]-i[NPrePre]-m[BPre]-phumelelo[NStem]
ngendlela	nga[AdvPre]-i[NPrePre]-n[BPre]-dlela[NStem]
ngeniso	ngeniso[NStem]
ngenxa	ngenxa[Conj]
ngethuba	nga[AdvPre]-i[NPrePre]-thuba[NStem]
ngexa	ngenxa[Conj]
ngexesha	nga[AdvPre]-i[NPrePre]-xesha[NStem]
ngo	ngo[Abbr]
ngoko	nga[AdvPre]-oko[Dem+Pos]
ngoku	ngoku[Adv]
ngokuba	nga[AdvPre]-ukuba[Conj]
ngokukhawuleza	nga[AdvPre]-u[NPrePre]-ku[BPre]-khawulez[VRoot]-a[VerbTerm]
ngokulinganayo	nga[AdvPre]-oku[RelConc]-lingan[VRoot]-a[VerbTerm]-yo[RelSuf]
ngokupheleleyo	nga[AdvPre]-oku[RelConc]-phelel[VRoot]-e[VerbTerm]-yo[RelSuf]
ngokusebenzisa	nga[AdvPre]-u[NPrePre]-ku[BPre]-sebenz[VRoot]-is[CausExt]-a[VerbTerm]
ngokuthe	nga[AdvPre]-oku[RelConc]-th[VRoot]-e[VerbTerm]
ngokutsha	nga[AdvPre]-oku[AdjPref]-tsha[AdjStem]
ngokwamaqela	nga[AdvPre]-okwa[AdvPre]-a[NPrePre]-ma[BPre]-qela[NStem]
ngokwenza	nga[AdvPre]-u[NPrePre]-ku[BPre]-enz[VRoot]-a[VerbTerm]
ngokwesini	nga[AdvPre]-okwa[AdvPre]-i[NPrePre]-si[BPre]-ni[NStem]
ngonyaka	nga[AdvPre]-u[NPrePre]-nyaka[NStem]
ngowama-2030	nga[AdvPre]-o[RelConc]-wa[PossConc]-a[NPrePre]-ma[BPre]-2030[Num]
ngqo	ngqo[Ideoph]
ngquzulwano	ngquzulwano[NStem]
ngubani	ng[CopPre]-u[NPrePre]-bani[Interrog]
nini	nini[Adv]
njalo	njalo[Adv]
njani	njani[Adv]
nje	nje[Adv]
njengendlela	njenga[AdvPre]-i[NPrePre]-n[BPre]-dlela[NStem]
njengoko	njenga[AdvPre]-oko[Dem+Pos]
njengokuba	njenga[AdvPre]-ukuba[Conj]
njl	njl[Abbr]
njl.	njl.[Abbr]
nkosi	nkosi[ProperName]
nkqu	nkqu[Adv]
no	no[Abbr]
noba	noba[Conj]
noceba	na[AdvPre]-u[NPrePre]-ceba[NStem]
noko	noko[Adv]
nokuba	na[AdvPre]-ukuba[Conj]
nokungalingani	na[AdvPre]-u[NPrePre]-ku[BPre]-nga[NegPre]-lingan[VRoot]-i[VerbTerm]
nokunika	na[AdvPre]-u[NPrePre]-ku[BPre]-nik[VRoot]-a[VerbTerm]
nokuqinisekisa	na[AdvPre]-u[NPrePre]-ku[BPre]-qinisek[VRoot]-is[CausExt]-a[VerbTerm]
nokusebenza	na[AdvPre]-u[NPrePre]-ku[BPre]-sebenz[VRoot]-a[VerbTerm]
nokwandisa	na[AdvPre]-u[NPrePre]-ku[BPre]-and[VRoot]-is[CausExt]-a[VerbTerm]
nolawulo	na[AdvPre]-u[NPrePre]-lawulo[NStem]
noluntu	na[AdvPre]-u[NPrePre]-lu[BPre]-ntu[NStem]
nolwazi	na[AdvPre]-u[NPrePre]-lu[BPre]-azi[NStem]
nomsebenzi	na[AdvPre]-u[NPrePre]-m[BPre]-sebenzi[NStem]
nonikezelo	na[AdvPre]-u[NPrePre]-nikezelo[NStem]
nophuhliso	na[AdvPre]-u[NPrePre]-phuhliso[NStem]
norhulumente	na[AdvPre]-u[NPrePre]-rhulumente[NStem]
nqanam	nqanam[NStem]
nto	n[BPre]-to[NStem]
ntoni	ntoni[Interrog]
ntsho	ntsho[Ideoph]
nxulumano	nxulumano[NStem]
nyaka	nyaka[NStem]
nyathelo	nyathelo[NStem]
nzima	nzima[RelStem]
nzulu	nzulu[RelStem]
o.k.t.	o.k.t.[Abbr]
obu	obu[Dem+Pos]
of	of[Foreign]
ofisi	ofisi[NStem]
okanye	okanye[Conj]
oko	oko[Dem+Pos]
okoko	okoko[Adv]
okt.	okt.[Abbr]
oku	oku[Dem+Pos]
okunye	okunye[Conj]
olandelayo	o[RelConc]-landel[VRoot]-a[VerbTerm]-yo[RelSuf]
olo	olo[Dem+Pos]
olu	olu[Dem+Pos]
olumanyanisiweyo	olu[RelConc]-many[VRoot]-an[RecipExt]-is[CausExt]-iw[PassExt]-e[VerbTerm]-yo[RelSuf]
oluntu	a[PossConc]-u[NPrePre]-lu[BPre]-ntu[NStem]
olunye	olu[AdjPref]-nye[AdjStem]
omnye	om[AdjPref]-nye[AdjStem]
ongezantsi	o[RelConc]-nga[AdvPre]-e[LocPre]-zantsi[Adv]
onke	o[QuantConc]-nke[QuantStem]
oomasipala	oo[NPrePre]-masipala[NStem]
organisation	organisation[Foreign]
orientations	orientations[Foreign]
othile	o[RelConc]-th[VRoot]-ile[Perf]
pack	pack[Foreign]
participation	participation[Foreign]
partnerships	partnerships[Foreign]
pasile	pasile[NStem]
patheni	patheni[NStem]
pcm	pcm[Abbr]
pele	pele[ProperName]
phakathi	phakathi[Adv]
phambi	phambi[Adv]
phambili	phambili[Adv]
phandle	phandle[Adv]
phantsi	phantsi[Adv]
phawu	phawu[NStem]
phaya	phaya[Dem+Pos]
phepha	phepha[NStem]
phezu	phezu[Adv]
phezulu	phezulu[Adv]
phi	phi[Interrog]
phinda	phinda[AuxVStem]
phononongo	phononongo[NStem]
plan	plan[Foreign]
planning	planning[Foreign]
pms	pms[Abbr]
poa	poa[Abbr]
ppp	ppp[Abbr]
private	private[Foreign]
programme	programme[Foreign]
project	project[Foreign]
projector	projector[Foreign]
projektha	projektha[NStem]
projekthi	projekthi[NStem]
property	property[Foreign]
public	public[Foreign]
qatha	qatha[Ideoph]
qela	qela[NStem]
qha	qha[Adv]
qho	qho[Ideoph]
qonga	qonga[NStem]
qoqosho	qoqosho[NStem]
qwalasela	qwalasel[VRoot]-a[VerbTerm]
r&d	r&d[Abbr]
rates	rates[Foreign]
relations	relations[Foreign]
representative	representative[Foreign]
responsive	responsive[Foreign]
result	result[Foreign]
revenue	revenue[Foreign]
rhoqo	rhoqo[Ideoph]
saa	saa[Ideoph]
sadc	sadc[Abbr]
salaam	salaam[ProperName]
salga	salga[Abbr]
sdip	sdip[Abbr]
sebe	sebe[NStem]
sebenzisa	sebenz[VRoot]-is[CausExt]-a[VerbTerm]
sele	sele[AuxVStem]
septemba	septemba[ProperName]
seshoni	seshoni[NStem]
sewadi	sa[PossConc]-i[NPrePre]-wadi[NStem]
sexual	sexual[Foreign]
shushu	shushu[Adv]
sicwangciso	si[BPre]-cwangciso[NStem]
sifuna	si[SC]-fun[VRoot]-a[VerbTerm]
simahla	simahla[Adv]
sisixhobo	s[CopPre]-i[NPrePre]-si[BPre]-xhobo[NStem]
smith	smith[ProperName]
sodolophu	sodolophu[NStem]
sokuba	sa[PossConc]-ukuba[Conj]
sophuhliso	sa[PossConc]-u[NPrePre]-phuhliso[NStem]
specific	specific[Foreign]
state	state[ProperName]
states	states[ProperName]
structures	structures[Foreign]
systems	systems[Foreign]
task	task[Foreign]
tb	tb[Abbr]
teams	teams[Foreign]
thaca	thaca[Ideoph]
the	the[Foreign]
together	together[Foreign]
transition	transition[Foreign]
transport	transport[Foreign]
tse	tse[Ideoph]
tshintsho	tshintsho[NStem]
tshiphu	tshiphu[Adv]
tshitshilili	tshitshilili[Ideoph]
tyala	tyala[NStem]
tye	tye[Ideoph]
ubomi	u[NPrePre]-bomi[NStem]
ubuhlwempu	u[NPrePre]-bu[BPre]-hlwempu[NStem]
ubulunga	u[NPrePre]-bu[BPre]-lunga[NStem]
ubume	u[NPrePre]-bu[BPre]-me[NStem]
uceba	u[NPrePre]-ceba[NStem]
udliwano-ndlebe	u[NPrePre]-dliwano[NStem]-n[BPre]-dlebe[NStem]
ufuna	u[SC]-fun[VRoot]-a[VerbTerm]
uhlahlo	u[NPrePre]-hlahlo[NStem]
uhlalutyo	u[NPrePre]-hlalutyo[NStem]
ukuba	ukuba[Conj]
ukubandakanywa	u[NPrePre]-ku[BPre]-bandakany[VRoot]-w[PassExt]-a[VerbTerm]
ukufikelela	u[NPrePre]-ku[BPre]-fikelel[VRoot]-a[VerbTerm]
ukufumana	u[NPrePre]-ku[BPre]-fuman[VRoot]-a[VerbTerm]
ukukhula	u[NPrePre]-ku[BPre]-khul[VRoot]-a[VerbTerm]
ukukhuthaza	u[NPrePre]-ku[BPre]-khuthaz[VRoot]-a[VerbTerm]
ukulingana	u[NPrePre]-ku[BPre]-lingan[VRoot]-a[VerbTerm]
ukumamela	u[NPrePre]-ku[BPre]-mamel[VRoot]-a[VerbTerm]
ukungafani	u[NPrePre]-ku[BPre]-nga[NegPre]-fan[VRoot]-i[VerbTerm]
ukungalingani	u[NPrePre]-ku[BPre]-nga[NegPre]-lingan[VRoot]-i[VerbTerm]
ukunika	u[NPrePre]-ku[BPre]-nik[VRoot]-a[VerbTerm]
ukunikezela	u[NPrePre]-ku[BPre]-nikezel[VRoot]-a[VerbTerm]
ukuphucula	u[NPrePre]-ku[BPre]-phucul[VRoot]-a[VerbTerm]
ukuphuhlisa	u[NPrePre]-ku[BPre]-phuhl[VRoot]-is[CausExt]-a[VerbTerm]
ukuphumeza	u[NPrePre]-ku[BPre]-phumez[VRoot]-a[VerbTerm]
ukuqinisekisa	u[NPrePre]-ku[BPre]-qinisek[VRoot]-is[CausExt]-a[VerbTerm]
ukuqonda	u[NPrePre]-ku[BPre]-qond[VRoot]-a[VerbTerm]
ukuquka	u[NPrePre]-ku[BPre]-quk[VRoot]-a[VerbTerm]
ukusebenza	u[NPrePre]-ku[BPre]-sebenz[VRoot]-a[VerbTerm]
ukusuka	u[NPrePre]-ku[BPre]-suk[VRoot]-a[VerbTerm]
ukuthatha	u[NPrePre]-ku[BPre]-thath[VRoot]-a[VerbTerm]
ukutshintsha	u[NPrePre]-ku[BPre]-tshintsh[VRoot]-a[VerbTerm]
ukuze	ukuze[Conj]
ukwakha	u[NPrePre]-ku[BPre]-akh[VRoot]-a[VerbTerm]
ukwandisa	u[NPrePre]-ku[BPre]-and[VRoot]-is[CausExt]-a[VerbTerm]
ukwenzela	u[NPrePre]-ku[BPre]-enz[VRoot]-el[ApplExt]-a[VerbTerm]
ukwenziwa	u[NPrePre]-ku[BPre]-enz[VRoot]-iw[PassExt]-a[VerbTerm]
ulawulo	u[NPrePre]-lawulo[NStem]
uludwe	u[NPrePre]-lu[BPre]-dwe[NStem]
uluhlu	u[NPrePre]-lu[BPre]-hlu[NStem]
uluntu	u[NPrePre]-lu[BPre]-ntu[NStem]
ulwazi	u[NPrePre]-lu[BPre]-azi[NStem]
umasipala	u[NPrePre]-masipala[NStem]
umba	u[NPrePre]-m[BPre]-ba[NStem]
umbhexeshi	u[NPrePre]-m[BPre]-bhexeshi[NStem]
umbono	u[NPrePre]-m[BPre]-bono[NStem]
umbuzo	u[NPrePre]-m[BPre]-buzo[NStem]
umgangatho	u[NPrePre]-m[BPre]-gangatho[NStem]
umgaqo-siseko	u[NPrePre]-m[BPre]-gaqo[NStem]-si[BPre]-seko[NStem]
umjikelo	u[NPrePre]-m[BPre]-jikelo[NStem]
umlinganiselo	u[NPrePre]-m[BPre]-linganiselo[NStem]
umntu	u[NPrePre]-m[BPre]-ntu[NStem]
umsebenzi	u[NPrePre]-m[BPre]-sebenzi[NStem]
umthetho	u[NPrePre]-m[BPre]-thetho[NStem]
umxolelanisi	u[NPrePre]-m[BPre]-xolelanisi[NStem]
umz	umz[Abbr]
umz.	umz.[Abbr]
umzantsi	u[NPrePre]-mzantsi[ProperName]
umzekelo	u[NPrePre]-m[BPre]-zekelo[NStem]
ungquzulwano	u[NPrePre]-ngquzulwano[NStem]
unikezelo	u[NPrePre]-nikezelo[NStem]
uninzi	u[NPrePre]-ninzi[NStem]
unxibelelwano	u[NPrePre]-nxibelelwano[NStem]
uphicotho	u[NPrePre]-phicotho[NStem]
uphuhliso	u[NPrePre]-phuhliso[NStem]
uqoqosho	u[NPrePre]-qoqosho[NStem]
urhulumente	u[NPrePre]-rhulumente[NStem]
urhwaphilizo	u[NPrePre]-rhwaphilizo[NStem]
uthungelwano	u[NPrePre]-thungelwano[NStem]
utyalo-mali	u[NPrePre]-tyalo[NStem]-mali[NStem]
uvavanyo	u[NPrePre]-vavanyo[NStem]
uxanduva	u[NPrePre]-xanduva[NStem]
uze	u[SC]-ze[AuxVStem]
vetshe	vetshe[Ideoph]
vimba	vimba[NStem]
wabo	wa[PossConc]-bo[PronStem]
wadi	wadi[NStem]
wakho	wa[PossConc]-kho[PossPron]
water	water[Foreign]
weengingqi	wa[PossConc]-i[NPrePre]-in[BPre]-gingqi[NStem]
wenkonzo	wa[PossConc]-i[NPrePre]-n[BPre]-khonzo[NStem]
weprojekthi	wa[PossConc]-i[NPrePre]-projekthi[NStem]
wewadi	wa[PossConc]-i[NPrePre]-wadi[NStem]
wokusebenza	wa[PossConc]-u[NPrePre]-ku[BPre]-sebenz[VRoot]-a[VerbTerm]
wonke	wo[QuantConc]-nke[QuantStem]
wophuhliso	wa[PossConc]-u[NPrePre]-phuhliso[NStem]
working	working[Foreign]
x	x[Foreign]
xa	xa[Conj]
xabiso	xabiso[NStem]
xanduva	xanduva[NStem]
xesha	xesha[NStem]
xhaxhe	xhaxhe[Ideoph]
xinezelelo	xinezelelo[NStem]
xyz	xyz[Abbr]
yabahlali	ya[PossConc]-a[NPrePre]-ba[BPre]-hlali[NStem]
yabantu	ya[PossConc]-a[NPrePre]-ba[BPre]-ntu[NStem]
yabo	ya[PossConc]-bo[PronStem]
yakhe	ya[PossConc]-khe[PossPron]
yakho	ya[PossConc]-kho[PossPron]
yamaqela	ya[PossConc]-a[NPrePre]-ma[BPre]-qela[NStem]
yantlukwano	yantlukwano[NStem]
yasekuhlaleni	ya[PossConc]-s[PreLoc-s]-e[LocPre]-u[NPrePre]-ku[BPre]-hlal[VRoot]-a[VerbTerm]-ini[LocSuf]
yawo	ya[PossConc]-wo[PronStem]
yayo	ya[PossConc]-yo[PronStem]
yazo	ya[PossConc]-zo[PronStem]
ye-cbp	ya[PossConc]-i[NPrePre]-cbp[Abbr]
ye-idp	ya[PossConc]-i[NPrePre]-idp[Abbr]
yebhunga	ya[PossConc]-i[NPrePre]-bhunga[NStem]
yekomiti	ya[PossConc]-i[NPrePre]-komiti[NStem]
yenkqubo	ya[PossConc]-i[NPrePre]-n[BPre]-kqubo[NStem]
yesicwangciso	ya[PossConc]-i[NPrePre]-si[BPre]-cwangciso[NStem]
yewadi	ya[PossConc]-i[NPrePre]-wadi[NStem]
yeyiphi	y[CopPre]-e[RelConc]-yi[EnumConc]-phi[EnumStem]
yikomiti	y[CopPre]-i[NPrePre]-komiti[NStem]
yindlela	y[CopPre]-i[NPrePre]-n[BPre]-dlela[NStem]
yinkqubo	y[CopPre]-i[NPrePre]-n[BPre]-kqubo[NStem]
yintoni	yi[CopPre]-n[BPre]-to[NStem]-ni[InterrogSuf]
yohlahlo	ya[PossConc]-u[NPrePre]-hlahlo[NStem]
yokuba	ya[PossConc]-ukuba[Conj]
yokusebenza	ya[PossConc]-u[NPrePre]-ku[BPre]-sebenz[VRoot]-a[VerbTerm]
yokwenza	ya[PossConc]-u[NPrePre]-ku[BPre]-enz[VRoot]-a[VerbTerm]
yokwenziwa	ya[PossConc]-u[NPrePre]-ku[BPre]-enz[VRoot]-iw[PassExt]-a[VerbTerm]
yolawulo	ya[PossConc]-u[NPrePre]-lawulo[NStem]
yoluntu	ya[PossConc]-u[NPrePre]-lu[BPre]-ntu[NStem]
yonke	yo[QuantConc]-nke[QuantStem]
yophuhliso	ya[PossConc]-u[NPrePre]-phuhliso[NStem]
z	z[Abbr]
zabantu	za[PossConc]-a[NPrePre]-ba[BPre]-ntu[NStem]
zabo	za[PossConc]-bo[PronStem]
zange	zange[AuxVStem]
zasekuhlaleni	za[PossConc]-s[PreLoc-s]-e[LocPre]-u[NPrePre]-ku[BPre]-hlal[VRoot]-a[VerbTerm]-ini[LocSuf]
zawo	za[PossConc]-wo[PronStem]
zebhunga	za[PossConc]-i[NPrePre]-bhunga[NStem]
zeewadi	za[PossConc]-i[NPrePre]-i[BPre]-wadi[NStem]
zengingqi	za[PossConc]-i[NPrePre]-n[BPre]-gingqi[NStem]
zeprojekthi	za[PossConc]-i[NPrePre]-projekthi[NStem]
zewadi	za[PossConc]-i[NPrePre]-wadi[NStem]
zikamasipala	zi[PossConc]-ka[PossKA]-masipala[NStem]
zikarhulumente	zi[PossConc]-ka[PossKA]-rhulumente[NStem]
zinika	zi[SC]-nik[VRoot]-a[VerbTerm]
ziya	zi[SC]-ya[Fut]
zokwenza	za[PossConc]-u[NPrePre]-ku[BPre]-enz[VRoot]-a[VerbTerm]
zolawulo	za[PossConc]-u[NPrePre]-lawulo[NStem]
zoluntu	za[PossConc]-u[NPrePre]-lu[BPre]-ntu[NStem]
zomsebenzi	za[PossConc]-u[NPrePre]-m[BPre]-sebenzi[NStem]
zonke	zo[QuantConc]-nke[QuantStem]
zophuhliso	za[PossConc]-u[NPrePre]-phuhliso[NStem]
zorhwebo	za[PossConc]-u[NPrePre]-rhwebo[NStem]
zungu	zungu[ProperName]
